[
  [ 87, 87, 87, 87, 87, 87, 87, 87, 87, 87, 87, 87, 87, 87, 87, 87, 87, 87, 87, 87, 87, 87, 87, 87, 87, 87, 87, 87, 87, 87, 87, 87, 87, 87, 87, 87, 87, 87, 87, 87, 87, 87, 87, 87, 87, 87, 87, 87, 87, 87, 87, 87, 87, 87, 87, 87, 87, 87, 87, 87, 87, 87, 87, 87, 87, 87, 87, 87, 87, 87, 87, 87, 87, 87, 87, 87, 87, 87, 87, 87, 87, 87 ],
  [ 87, 87, 87, 87, 87, 87, 87, 87, 87, 83, 83, 83, 83, 83, 83, 83, 83, 83, 83, 83, 83, 87, 87, 87, 87, 87, 87, 87, 87, 87, 87, 87, 87, 87, 87, 87, 87, 87, 87, 87, 87, 87, 87, 87, 87, 87, 87, 87, 87, 87, 87, 87, 87, 87, 87, 87, 87, 87, 87, 87, 87, 87, 87, 87, 87, 87, 87, 87, 87, 87, 87, 87, 87, 87, 87, 87, 87, 87, 87, 87, 87, 87 ],
  [ 87, 87, 87, 87, 87, 87, 87, 87, 87, 83, 83, 83, 83, 83, 83, 83, 83, 83, 83, 83, 83, 87, 87, 87, 87, 87, 87, 87, 87, 87, 87, 87, 87, 87, 87, 87, 87, 87, 87, 87, 87, 87, 87, 87, 87, 87, 87, 87, 87, 87, 87, 87, 87, 87, 87, 87, 87, 87, 87, 87, 87, 87, 87, 87, 87, 87, 87, 87, 87, 87, 87, 87, 87, 87, 87, 87, 87, 87, 87, 87, 87, 87 ],
  [ 87, 87, 87, 87, 87, 87, 87, 87, 87, 83, 83, 83, 83, 83, 83, 83, 83, 83, 83, 83, 83, 87, 87, 87, 87, 87, 87, 87, 87, 87, 87, 87, 87, 87, 87, 87, 87, 87, 87, 87, 87, 87, 87, 87, 87, 87, 87, 87, 87, 87, 87, 87, 87, 87, 87, 87, 87, 87, 87, 87, 87, 87, 87, 87, 87, 87, 87, 87, 87, 87, 87, 87, 87, 87, 87, 87, 87, 87, 87, 87, 87, 87 ],
  [ 87, 87, 87, 87, 87, 87, 87, 87, 87, 83, 83, 83, 83, 83, 83, 83, 83, 83, 83, 83, 83, 87, 87, 87, 87, 87, 87, 87, 87, 87, 87, 87, 87, 87, 87, 87, 87, 87, 87, 87, 87, 87, 87, 87, 87, 87, 87, 87, 87, 87, 87, 87, 87, 87, 87, 87, 87, 87, 87, 87, 87, 87, 87, 87, 87, 87, 87, 87, 87, 87, 87, 87, 87, 87, 87, 87, 87, 87, 87, 87, 87, 87 ],
  [ 87, 87, 87, 87, 87, 87, 87, 87, 87, 83, 83, 83, 83, 83, 83, 83, 83, 83, 83, 83, 87, 87, 87, 87, 87, 87, 87, 87, 87, 87, 87, 87, 87, 87, 87, 87, 87, 87, 87, 87, 87, 87, 87, 87, 87, 87, 87, 87, 87, 87, 87, 87, 87, 87, 87, 87, 87, 87, 87, 87, 87, 87, 87, 87, 87, 87, 87, 87, 87, 87, 87, 87, 87, 87, 87, 87, 87, 87, 87, 87, 87, 87 ],
  [ 87, 87, 87, 87, 87, 87, 87, 87, 87, 83, 83, 83, 83, 83, 83, 83, 83, 83, 83, 83, 83, 87, 87, 87, 87, 87, 87, 87, 87, 87, 87, 87, 87, 87, 87, 87, 87, 87, 87, 87, 87, 87, 87, 87, 87, 87, 87, 87, 87, 87, 87, 87, 87, 87, 87, 87, 87, 87, 87, 87, 87, 87, 87, 87, 87, 87, 87, 87, 87, 87, 87, 87, 87, 87, 87, 87, 87, 87, 87, 87, 87, 87 ],
  [ 87, 87, 87, 87, 87, 87, 87, 87, 87, 83, 83, 83, 83, 83, 83, 83, 83, 83, 83, 83, 83, 83, 83, 83, 83, 83, 83, 83, 83, 83, 83, 83, 83, 83, 83, 83, 83, 83, 83, 83, 83, 87, 87, 87, 87, 83, 83, 87, 87, 87, 87, 87, 87, 87, 87, 87, 87, 87, 87, 87, 87, 87, 87, 87, 87, 87, 87, 83, 83, 87, 87, 87, 87, 87, 87, 87, 87, 87, 87, 87, 87, 87 ],
  [ 87, 87, 87, 87, 87, 87, 87, 87, 87, 83, 83, 83, 83, 83, 83, 83, 83, 83, 83, 83, 83, 83, 83, 83, 83, 83, 83, 83, 83, 83, 83, 83, 83, 83, 83, 83, 83, 83, 83, 83, 83, 87, 87, 87, 87, 83, 83, 87, 87, 87, 87, 87, 87, 87, 87, 87, 87, 87, 87, 87, 87, 87, 87, 87, 87, 87, 87, 83, 83, 87, 87, 87, 87, 87, 87, 87, 87, 87, 87, 87, 87, 87 ],
  [ 87, 87, 87, 87, 87, 87, 87, 87, 87, 83, 83, 83, 83, 83, 83, 83, 83, 83, 83, 83, 83, 83, 83, 83, 83, 83, 83, 83, 83, 83, 83, 83, 83, 83, 83, 83, 83, 83, 87, 83, 83, 87, 87, 87, 87, 83, 83, 87, 87, 87, 87, 87, 87, 87, 87, 87, 87, 87, 87, 87, 87, 87, 87, 87, 87, 87, 87, 83, 83, 87, 87, 87, 87, 87, 87, 87, 87, 87, 87, 87, 87, 87 ],
  [ 87, 87, 87, 87, 87, 87, 87, 87, 87, 83, 83, 83, 83, 83, 83, 83, 83, 83, 83, 83, 83, 83, 83, 83, 83, 83, 83, 83, 83, 83, 83, 83, 83, 83, 87, 83, 87, 87, 87, 87, 83, 87, 87, 87, 87, 83, 83, 87, 87, 87, 87, 87, 87, 87, 87, 87, 87, 87, 87, 87, 87, 87, 87, 87, 87, 87, 87, 83, 83, 87, 87, 87, 87, 87, 87, 87, 87, 87, 87, 87, 87, 87 ],
  [ 87, 87, 87, 87, 87, 87, 87, 87, 87, 83, 83, 83, 83, 83, 83, 83, 83, 83, 83, 83, 83, 83, 83, 83, 83, 83, 83, 83, 83, 83, 83, 83, 83, 83, 83, 83, 87, 87, 87, 87, 83, 87, 87, 87, 87, 83, 83, 87, 87, 87, 87, 87, 87, 87, 87, 87, 87, 87, 87, 87, 87, 87, 87, 87, 87, 87, 87, 83, 83, 87, 87, 87, 87, 87, 87, 87, 87, 87, 87, 87, 87, 87 ],
  [ 87, 87, 87, 87, 87, 87, 87, 87, 87, 83, 87, 83, 83, 83, 83, 83, 83, 83, 83, 83, 83, 83, 83, 83, 83, 83, 83, 83, 83, 83, 83, 83, 83, 83, 83, 83, 83, 83, 83, 83, 83, 83, 83, 83, 83, 83, 83, 87, 87, 87, 87, 87, 87, 87, 87, 87, 87, 87, 87, 87, 87, 87, 87, 87, 87, 87, 87, 83, 83, 87, 87, 87, 87, 87, 87, 87, 87, 87, 87, 87, 87, 87 ],
  [ 87, 87, 87, 87, 87, 87, 87, 87, 87, 83, 83, 83, 83, 83, 83, 83, 83, 83, 83, 83, 83, 83, 83, 83, 83, 83, 83, 83, 83, 83, 83, 83, 83, 83, 83, 83, 83, 83, 83, 83, 83, 83, 83, 83, 83, 83, 83, 87, 87, 87, 87, 87, 87, 87, 87, 87, 87, 87, 87, 87, 87, 87, 87, 87, 87, 87, 87, 83, 83, 87, 87, 87, 87, 87, 87, 87, 87, 87, 87, 87, 87, 87 ],
  [ 87, 87, 87, 87, 87, 87, 87, 87, 87, 87, 87, 83, 83, 83, 83, 83, 83, 83, 83, 83, 83, 83, 83, 83, 83, 83, 83, 83, 83, 83, 83, 83, 83, 83, 83, 83, 83, 83, 83, 83, 83, 83, 83, 83, 83, 83, 83, 87, 87, 87, 87, 87, 87, 87, 87, 87, 87, 87, 87, 87, 87, 83, 83, 83, 83, 83, 83, 83, 83, 87, 87, 87, 87, 87, 87, 87, 87, 87, 87, 87, 87, 87 ],
  [ 87, 87, 87, 87, 87, 87, 87, 87, 87, 87, 87, 83, 83, 83, 83, 83, 83, 83, 83, 83, 83, 83, 83, 83, 83, 83, 83, 83, 83, 83, 83, 83, 83, 83, 83, 83, 83, 83, 83, 83, 83, 83, 83, 83, 87, 87, 87, 87, 83, 83, 83, 83, 83, 83, 83, 83, 83, 83, 83, 83, 83, 83, 83, 83, 83, 83, 83, 83, 83, 87, 87, 87, 87, 87, 87, 87, 87, 87, 87, 87, 87, 87 ],
  [ 87, 87, 87, 87, 87, 87, 87, 87, 87, 87, 87, 83, 83, 83, 83, 83, 83, 83, 83, 83, 83, 83, 83, 83, 83, 83, 83, 83, 83, 83, 83, 83, 83, 83, 83, 83, 83, 83, 83, 83, 83, 83, 83, 83, 83, 83, 83, 83, 83, 83, 83, 83, 83, 83, 83, 83, 83, 83, 83, 83, 83, 83, 83, 83, 83, 83, 83, 83, 83, 87, 87, 87, 87, 87, 87, 87, 87, 87, 87, 87, 87, 87 ],
  [ 87, 87, 83, 83, 83, 83, 83, 83, 83, 83, 83, 83, 83, 83, 83, 83, 83, 83, 83, 83, 83, 83, 83, 83, 83, 83, 83, 83, 83, 83, 83, 83, 83, 83, 83, 83, 83, 83, 83, 83, 83, 83, 83, 83, 83, 83, 83, 83, 83, 83, 83, 83, 83, 83, 83, 83, 83, 83, 83, 83, 83, 83, 83, 83, 83, 83, 83, 83, 83, 87, 87, 87, 87, 87, 87, 87, 87, 87, 87, 87, 87, 87 ],
  [ 87, 87, 83, 83, 83, 83, 83, 83, 83, 83, 83, 83, 83, 83, 83, 83, 83, 83, 83, 83, 83, 83, 83, 83, 83, 83, 83, 83, 83, 83, 83, 83, 83, 83, 83, 83, 83, 83, 83, 83, 83, 83, 83, 83, 83, 83, 83, 83, 83, 83, 83, 83, 83, 83, 83, 83, 83, 83, 83, 83, 83, 83, 83, 83, 83, 83, 83, 83, 83, 87, 87, 87, 87, 87, 87, 87, 87, 87, 87, 87, 87, 87 ],
  [ 87, 87, 83, 83, 83, 83, 83, 83, 83, 83, 83, 83, 83, 83, 83, 83, 83, 83, 83, 83, 83, 83, 83, 83, 83, 83, 83, 83, 83, 83, 83, 83, 83, 83, 83, 83, 83, 83, 83, 83, 83, 83, 83, 83, 83, 83, 83, 83, 83, 83, 83, 83, 83, 83, 83, 83, 83, 83, 83, 83, 83, 83, 83, 83, 83, 83, 83, 83, 83, 87, 87, 87, 87, 87, 87, 87, 87, 87, 87, 87, 87, 87 ],
  [ 87, 87, 83, 83, 83, 83, 83, 83, 83, 83, 83, 83, 83, 83, 83, 83, 83, 83, 83, 83, 83, 83, 83, 83, 83, 83, 83, 83, 83, 83, 83, 83, 83, 83, 83, 83, 83, 83, 83, 83, 83, 83, 83, 83, 83, 83, 83, 83, 83, 83, 83, 83, 83, 83, 83, 83, 83, 83, 83, 83, 83, 83, 83, 83, 83, 83, 83, 83, 83, 87, 87, 87, 87, 87, 87, 87, 87, 87, 87, 87, 87, 87 ],
  [ 87, 87, 83, 83, 83, 83, 83, 83, 83, 83, 83, 83, 83, 83, 83, 83, 83, 83, 83, 83, 83, 83, 83, 87, 87, 83, 83, 83, 83, 83, 83, 83, 83, 83, 83, 83, 83, 83, 83, 83, 83, 83, 83, 87, 87, 87, 87, 87, 83, 83, 83, 83, 83, 83, 83, 83, 83, 83, 83, 83, 83, 83, 83, 83, 83, 83, 83, 83, 83, 87, 87, 87, 87, 87, 87, 87, 87, 87, 87, 87, 87, 87 ],
  [ 87, 87, 83, 83, 83, 83, 83, 83, 83, 83, 83, 83, 83, 83, 83, 83, 83, 83, 83, 83, 83, 83, 87, 87, 87, 87, 83, 83, 83, 83, 83, 83, 83, 83, 83, 83, 83, 83, 83, 83, 83, 83, 83, 87, 83, 83, 83, 87, 83, 83, 83, 83, 83, 83, 83, 83, 83, 83, 83, 83, 83, 83, 83, 83, 83, 83, 83, 83, 83, 87, 87, 87, 87, 87, 87, 87, 87, 87, 87, 87, 87, 87 ],
  [ 87, 87, 83, 83, 83, 83, 83, 83, 83, 83, 83, 83, 83, 83, 83, 83, 83, 83, 83, 83, 83, 83, 87, 87, 87, 87, 83, 83, 83, 83, 83, 83, 83, 83, 83, 83, 83, 83, 83, 83, 83, 83, 83, 83, 83, 83, 83, 87, 83, 83, 83, 83, 83, 83, 83, 83, 83, 83, 83, 83, 83, 83, 83, 83, 83, 83, 83, 83, 83, 87, 87, 87, 87, 87, 87, 87, 87, 87, 87, 87, 87, 87 ],
  [ 87, 87, 83, 83, 83, 83, 83, 83, 83, 83, 83, 83, 83, 83, 83, 83, 83, 83, 83, 83, 87, 87, 87, 87, 87, 87, 83, 87, 83, 83, 83, 83, 83, 83, 83, 83, 83, 83, 83, 83, 83, 83, 83, 83, 83, 83, 83, 87, 83, 83, 83, 83, 83, 83, 83, 83, 83, 83, 83, 83, 83, 83, 83, 83, 83, 83, 83, 83, 83, 87, 87, 87, 87, 87, 87, 87, 87, 87, 87, 87, 87, 87 ],
  [ 87, 87, 83, 83, 83, 83, 83, 83, 83, 83, 83, 83, 83, 83, 83, 83, 83, 83, 83, 83, 83, 87, 87, 87, 87, 87, 87, 87, 83, 83, 83, 83, 83, 83, 83, 83, 83, 83, 83, 83, 83, 83, 83, 83, 83, 83, 83, 87, 83, 83, 83, 83, 83, 83, 83, 83, 83, 83, 83, 83, 83, 83, 83, 83, 83, 83, 83, 83, 83, 87, 87, 87, 87, 87, 87, 87, 87, 87, 87, 87, 87, 87 ],
  [ 87, 87, 83, 83, 83, 83, 83, 83, 83, 83, 83, 83, 83, 83, 83, 83, 83, 83, 83, 83, 83, 83, 83, 83, 87, 87, 87, 87, 83, 83, 83, 83, 83, 83, 83, 83, 83, 83, 83, 83, 83, 83, 83, 83, 83, 83, 83, 87, 83, 83, 83, 83, 83, 83, 83, 83, 83, 83, 83, 83, 83, 83, 83, 83, 83, 83, 83, 83, 83, 87, 87, 87, 87, 87, 87, 87, 87, 87, 87, 87, 87, 87 ],
  [ 87, 87, 87, 87, 83, 83, 83, 83, 87, 87, 87, 87, 87, 87, 87, 87, 87, 87, 87, 87, 83, 83, 83, 83, 87, 87, 87, 87, 83, 83, 83, 83, 83, 83, 83, 83, 83, 83, 83, 83, 83, 83, 83, 87, 87, 87, 87, 87, 83, 83, 83, 83, 83, 83, 83, 83, 83, 83, 83, 83, 83, 83, 83, 83, 83, 83, 83, 83, 83, 87, 87, 87, 87, 87, 87, 87, 87, 87, 87, 87, 87, 87 ],
  [ 87, 87, 87, 87, 83, 83, 83, 83, 87, 87, 87, 87, 87, 87, 87, 87, 87, 87, 87, 87, 83, 83, 83, 83, 87, 87, 87, 87, 83, 83, 83, 83, 83, 83, 83, 83, 83, 83, 83, 83, 83, 83, 83, 87, 87, 87, 87, 83, 83, 83, 83, 83, 83, 83, 83, 83, 83, 83, 83, 83, 83, 83, 83, 83, 83, 83, 83, 83, 83, 87, 87, 87, 87, 87, 87, 87, 87, 87, 87, 87, 87, 87 ],
  [ 87, 87, 87, 87, 83, 83, 83, 83, 87, 87, 87, 87, 87, 87, 87, 87, 87, 87, 87, 87, 83, 83, 83, 83, 83, 83, 83, 83, 83, 83, 83, 83, 83, 83, 83, 83, 83, 83, 83, 83, 83, 83, 83, 87, 87, 87, 87, 83, 83, 83, 83, 83, 83, 83, 83, 83, 83, 83, 83, 83, 83, 83, 83, 83, 83, 83, 83, 83, 83, 87, 87, 87, 87, 87, 87, 87, 87, 87, 87, 87, 87, 87 ],
  [ 87, 87, 87, 87, 83, 83, 83, 83, 87, 87, 87, 87, 87, 87, 87, 87, 87, 87, 87, 87, 87, 87, 83, 83, 83, 83, 83, 83, 83, 83, 83, 83, 83, 83, 83, 83, 83, 83, 83, 83, 83, 83, 83, 87, 87, 87, 87, 83, 83, 83, 83, 83, 83, 83, 83, 83, 83, 83, 83, 83, 83, 83, 83, 83, 83, 83, 83, 83, 83, 87, 87, 87, 87, 87, 87, 87, 87, 87, 87, 87, 87, 87 ],
  [ 87, 83, 83, 83, 83, 83, 83, 83, 83, 83, 83, 83, 87, 87, 87, 87, 83, 87, 87, 87, 87, 87, 83, 83, 87, 83, 83, 83, 83, 83, 83, 83, 83, 83, 83, 83, 83, 83, 83, 83, 83, 83, 83, 87, 87, 87, 87, 83, 83, 83, 83, 83, 83, 83, 83, 83, 83, 83, 83, 83, 83, 83, 83, 83, 83, 83, 83, 83, 83, 87, 87, 87, 87, 87, 87, 87, 87, 87, 87, 87, 87, 87 ],
  [ 87, 83, 83, 83, 83, 83, 83, 83, 83, 83, 83, 83, 87, 87, 87, 87, 83, 83, 87, 87, 87, 87, 83, 83, 83, 83, 83, 83, 83, 83, 83, 83, 83, 83, 83, 83, 83, 83, 83, 83, 83, 83, 83, 87, 87, 87, 87, 83, 83, 83, 83, 83, 83, 83, 83, 83, 83, 83, 83, 83, 83, 83, 83, 83, 83, 83, 83, 83, 83, 87, 87, 87, 87, 87, 87, 87, 87, 87, 87, 87, 87, 87 ],
  [ 87, 83, 83, 83, 83, 83, 83, 83, 83, 83, 87, 83, 83, 83, 83, 83, 83, 83, 87, 87, 87, 87, 83, 83, 83, 83, 83, 83, 83, 83, 83, 83, 83, 83, 83, 83, 83, 83, 83, 83, 83, 83, 83, 87, 83, 83, 83, 83, 83, 83, 83, 83, 83, 83, 83, 83, 83, 83, 83, 83, 83, 83, 83, 83, 83, 83, 83, 83, 83, 87, 87, 87, 87, 87, 87, 87, 87, 87, 87, 87, 87, 87 ],
  [ 87, 83, 83, 83, 83, 83, 83, 83, 83, 83, 83, 83, 83, 83, 83, 83, 83, 83, 87, 87, 87, 87, 83, 83, 83, 83, 83, 83, 83, 83, 83, 83, 83, 83, 83, 83, 83, 83, 83, 83, 87, 87, 87, 87, 83, 83, 83, 83, 83, 83, 83, 83, 83, 83, 83, 83, 83, 83, 83, 83, 83, 83, 83, 83, 83, 83, 83, 83, 83, 87, 87, 87, 87, 87, 87, 87, 87, 87, 87, 87, 87, 87 ],
  [ 87, 83, 83, 83, 83, 83, 83, 83, 83, 83, 83, 83, 83, 83, 83, 83, 83, 83, 87, 87, 87, 87, 83, 83, 83, 83, 83, 83, 83, 83, 83, 83, 83, 83, 83, 83, 83, 83, 83, 83, 87, 83, 83, 83, 83, 83, 83, 83, 83, 83, 83, 83, 83, 83, 83, 83, 83, 83, 83, 83, 83, 83, 83, 83, 83, 83, 83, 83, 83, 87, 87, 87, 87, 87, 87, 87, 87, 87, 87, 87, 87, 87 ],
  [ 87, 83, 83, 83, 83, 83, 83, 83, 83, 83, 83, 83, 83, 83, 83, 83, 83, 83, 87, 87, 87, 87, 87, 87, 87, 87, 87, 87, 87, 87, 87, 87, 87, 87, 87, 87, 87, 87, 87, 87, 83, 83, 83, 83, 83, 83, 83, 83, 83, 83, 83, 83, 83, 83, 83, 83, 83, 83, 83, 83, 83, 83, 83, 83, 83, 83, 83, 83, 83, 83, 83, 83, 87, 87, 87, 87, 87, 87, 87, 87, 87, 87 ],
  [ 87, 83, 83, 83, 83, 83, 83, 83, 83, 83, 83, 83, 83, 83, 83, 83, 83, 83, 87, 87, 87, 87, 87, 87, 87, 87, 87, 87, 87, 87, 87, 87, 87, 87, 87, 87, 87, 87, 87, 87, 83, 83, 83, 83, 83, 83, 83, 83, 83, 83, 83, 83, 83, 83, 83, 83, 83, 83, 83, 83, 83, 83, 83, 83, 83, 83, 83, 83, 83, 83, 83, 83, 87, 87, 87, 87, 87, 87, 87, 87, 87, 87 ],
  [ 87, 83, 83, 83, 83, 83, 83, 83, 83, 83, 83, 83, 83, 83, 83, 83, 83, 83, 87, 87, 87, 87, 83, 83, 83, 83, 83, 83, 83, 83, 83, 83, 83, 83, 83, 83, 83, 83, 83, 83, 83, 83, 83, 83, 83, 83, 83, 83, 83, 83, 83, 83, 83, 83, 83, 83, 83, 83, 83, 83, 83, 83, 83, 83, 83, 83, 83, 83, 83, 83, 83, 83, 87, 87, 87, 87, 87, 87, 87, 87, 87, 87 ],
  [ 87, 83, 83, 83, 83, 83, 83, 83, 83, 83, 83, 83, 83, 83, 83, 83, 83, 83, 87, 87, 87, 87, 83, 83, 83, 83, 83, 83, 83, 83, 83, 83, 83, 83, 83, 83, 83, 83, 83, 83, 83, 83, 83, 83, 83, 83, 83, 83, 83, 83, 83, 83, 83, 83, 83, 83, 83, 83, 83, 83, 83, 83, 83, 83, 83, 83, 83, 83, 83, 83, 83, 83, 87, 87, 87, 87, 87, 87, 87, 87, 87, 87 ],
  [ 87, 83, 83, 83, 83, 83, 83, 83, 83, 83, 83, 83, 83, 83, 83, 83, 83, 83, 87, 87, 87, 87, 83, 83, 83, 83, 83, 83, 83, 83, 83, 83, 83, 83, 83, 83, 83, 83, 83, 83, 83, 83, 83, 83, 83, 83, 83, 83, 83, 83, 83, 83, 83, 83, 83, 83, 83, 83, 83, 83, 83, 83, 83, 83, 83, 83, 83, 83, 83, 83, 83, 83, 87, 87, 87, 87, 87, 87, 87, 87, 87, 87 ],
  [ 87, 83, 83, 83, 83, 83, 83, 83, 83, 83, 83, 83, 83, 83, 83, 83, 87, 87, 87, 87, 87, 87, 87, 87, 87, 87, 87, 87, 87, 87, 87, 87, 83, 83, 83, 83, 83, 83, 83, 83, 83, 83, 83, 83, 83, 83, 83, 83, 83, 83, 83, 83, 83, 83, 83, 83, 83, 83, 83, 83, 83, 83, 83, 83, 83, 83, 83, 83, 83, 83, 83, 83, 87, 87, 87, 87, 87, 87, 87, 87, 87, 87 ],
  [ 87, 83, 83, 83, 83, 83, 83, 83, 83, 83, 83, 83, 83, 83, 83, 87, 87, 87, 87, 87, 87, 87, 87, 87, 87, 87, 87, 87, 87, 87, 87, 87, 87, 83, 83, 83, 83, 83, 83, 83, 83, 83, 83, 83, 83, 83, 83, 83, 83, 83, 83, 83, 83, 83, 83, 83, 83, 83, 83, 83, 83, 83, 83, 83, 83, 83, 83, 83, 83, 83, 83, 83, 87, 87, 87, 87, 87, 87, 87, 87, 87, 87 ],
  [ 87, 83, 83, 83, 83, 83, 83, 83, 83, 83, 83, 83, 83, 83, 83, 87, 87, 87, 87, 87, 87, 87, 87, 87, 87, 87, 87, 87, 87, 87, 87, 87, 87, 83, 83, 83, 83, 83, 83, 83, 83, 83, 83, 83, 83, 83, 83, 83, 83, 83, 83, 83, 83, 83, 83, 83, 83, 83, 83, 83, 83, 83, 83, 83, 83, 83, 83, 83, 83, 83, 83, 83, 87, 87, 87, 87, 87, 87, 87, 87, 87, 87 ],
  [ 87, 83, 83, 83, 83, 83, 83, 83, 83, 83, 83, 83, 83, 87, 87, 87, 87, 87, 87, 87, 87, 87, 87, 87, 87, 87, 87, 87, 87, 87, 87, 87, 87, 87, 83, 83, 83, 83, 83, 83, 83, 83, 83, 83, 83, 83, 83, 83, 83, 83, 83, 83, 83, 83, 83, 83, 83, 83, 83, 83, 83, 83, 83, 83, 83, 83, 83, 83, 83, 83, 83, 83, 87, 87, 87, 87, 87, 87, 87, 87, 87, 87 ],
  [ 87, 83, 83, 83, 83, 83, 83, 83, 83, 83, 83, 83, 83, 87, 87, 87, 87, 87, 87, 87, 87, 87, 87, 87, 87, 87, 87, 87, 87, 87, 87, 87, 87, 87, 83, 83, 83, 83, 83, 83, 83, 83, 83, 83, 83, 83, 83, 83, 83, 83, 83, 83, 83, 83, 83, 83, 83, 83, 83, 83, 83, 83, 83, 83, 83, 83, 83, 83, 83, 83, 83, 83, 83, 83, 83, 83, 87, 87, 87, 87, 87, 87 ],
  [ 87, 83, 83, 83, 83, 83, 83, 83, 83, 83, 83, 83, 83, 87, 87, 87, 87, 87, 87, 87, 87, 87, 87, 87, 87, 87, 87, 87, 87, 87, 87, 87, 87, 87, 87, 87, 87, 87, 87, 87, 87, 87, 87, 87, 87, 87, 87, 87, 87, 87, 87, 83, 83, 83, 83, 83, 83, 83, 83, 83, 83, 83, 83, 83, 83, 83, 83, 83, 83, 83, 83, 83, 83, 83, 83, 83, 87, 87, 87, 87, 87, 87 ],
  [ 87, 83, 83, 83, 83, 83, 83, 83, 83, 83, 83, 83, 83, 87, 87, 87, 87, 87, 87, 87, 87, 87, 87, 87, 87, 87, 87, 87, 87, 87, 87, 87, 87, 87, 87, 87, 87, 87, 87, 87, 87, 87, 87, 87, 87, 87, 87, 87, 87, 87, 87, 83, 83, 83, 83, 83, 83, 83, 83, 83, 83, 83, 83, 83, 83, 83, 83, 83, 83, 83, 83, 83, 83, 83, 83, 83, 87, 87, 87, 87, 87, 87 ],
  [ 87, 83, 83, 83, 83, 83, 83, 83, 83, 83, 83, 83, 83, 87, 87, 87, 87, 87, 87, 87, 87, 87, 87, 87, 87, 87, 87, 87, 87, 87, 87, 87, 87, 87, 87, 87, 87, 87, 87, 87, 87, 87, 87, 87, 87, 87, 87, 87, 87, 87, 87, 87, 87, 83, 83, 83, 83, 83, 83, 83, 83, 83, 83, 83, 83, 87, 83, 83, 83, 83, 83, 87, 83, 83, 83, 83, 83, 83, 83, 83, 83, 87 ],
  [ 87, 83, 83, 83, 83, 83, 83, 83, 83, 83, 83, 83, 83, 87, 87, 87, 87, 87, 87, 87, 87, 87, 87, 87, 87, 87, 87, 87, 87, 87, 87, 87, 87, 87, 87, 87, 87, 87, 87, 87, 87, 87, 87, 87, 87, 87, 87, 87, 87, 87, 87, 87, 87, 83, 83, 83, 83, 83, 83, 83, 83, 83, 83, 83, 83, 87, 83, 83, 83, 83, 83, 87, 83, 83, 83, 83, 83, 83, 83, 83, 83, 87 ],
  [ 87, 83, 83, 83, 83, 83, 83, 83, 83, 83, 83, 83, 83, 87, 87, 87, 87, 87, 87, 87, 87, 87, 87, 87, 87, 87, 87, 87, 87, 87, 87, 87, 87, 87, 87, 87, 87, 87, 87, 87, 87, 87, 87, 87, 87, 87, 87, 87, 87, 87, 87, 87, 87, 83, 83, 83, 83, 83, 83, 83, 83, 87, 87, 87, 87, 87, 83, 83, 83, 83, 83, 87, 87, 87, 87, 87, 87, 87, 87, 87, 87, 87 ],
  [ 87, 83, 83, 83, 83, 83, 83, 83, 83, 83, 83, 83, 83, 87, 87, 87, 87, 87, 87, 87, 87, 87, 87, 87, 87, 87, 87, 87, 87, 87, 87, 87, 87, 87, 87, 87, 87, 87, 87, 87, 87, 87, 87, 87, 87, 87, 87, 87, 87, 87, 87, 87, 87, 83, 83, 83, 83, 83, 83, 83, 83, 87, 87, 87, 87, 87, 83, 83, 83, 83, 83, 87, 87, 87, 87, 87, 87, 87, 87, 87, 87, 87 ],
  [ 87, 83, 83, 83, 83, 83, 83, 83, 83, 83, 83, 83, 83, 87, 87, 87, 87, 87, 87, 87, 87, 87, 87, 87, 87, 87, 87, 87, 87, 87, 87, 87, 87, 83, 83, 83, 83, 83, 83, 83, 83, 83, 83, 83, 83, 87, 87, 87, 87, 87, 87, 87, 87, 83, 83, 83, 83, 83, 83, 83, 83, 87, 83, 83, 83, 83, 83, 83, 83, 83, 83, 83, 83, 83, 83, 83, 83, 83, 83, 83, 83, 87 ],
  [ 87, 83, 83, 83, 83, 83, 83, 83, 83, 83, 83, 83, 83, 87, 87, 87, 87, 87, 87, 87, 87, 87, 87, 87, 87, 87, 87, 87, 87, 87, 87, 87, 87, 83, 83, 83, 83, 83, 83, 83, 83, 83, 83, 83, 83, 83, 87, 87, 87, 87, 87, 87, 87, 83, 83, 83, 83, 83, 83, 83, 87, 87, 83, 83, 83, 83, 83, 83, 83, 83, 83, 83, 83, 83, 83, 83, 83, 83, 83, 83, 83, 87 ],
  [ 87, 83, 83, 83, 83, 83, 83, 83, 83, 83, 83, 83, 83, 87, 87, 87, 87, 87, 87, 87, 87, 87, 87, 87, 87, 87, 87, 87, 87, 87, 87, 87, 87, 83, 83, 83, 83, 83, 83, 83, 83, 83, 83, 83, 83, 83, 87, 87, 87, 87, 87, 87, 87, 83, 83, 83, 83, 83, 83, 83, 83, 87, 83, 83, 83, 83, 83, 83, 83, 83, 83, 83, 83, 83, 83, 83, 83, 83, 83, 83, 83, 87 ],
  [ 87, 83, 83, 83, 83, 83, 83, 83, 83, 83, 83, 83, 83, 83, 83, 87, 87, 87, 87, 87, 87, 87, 87, 87, 87, 83, 83, 87, 87, 87, 83, 83, 83, 83, 83, 83, 83, 83, 83, 83, 83, 87, 83, 83, 83, 83, 87, 87, 87, 87, 87, 87, 87, 87, 87, 87, 87, 87, 87, 87, 87, 87, 83, 83, 83, 83, 83, 83, 83, 83, 83, 83, 83, 83, 83, 83, 83, 83, 83, 83, 83, 87 ],
  [ 87, 83, 83, 83, 83, 83, 83, 83, 83, 83, 83, 83, 83, 83, 83, 87, 87, 87, 87, 87, 87, 87, 87, 87, 83, 83, 83, 87, 87, 87, 83, 83, 83, 83, 83, 83, 83, 83, 83, 83, 83, 83, 87, 87, 87, 87, 87, 87, 87, 87, 87, 87, 87, 87, 87, 87, 87, 87, 87, 87, 87, 83, 83, 83, 83, 83, 83, 83, 83, 83, 83, 83, 83, 83, 83, 83, 83, 83, 83, 83, 83, 87 ],
  [ 87, 83, 83, 83, 83, 83, 83, 83, 83, 83, 83, 83, 83, 83, 83, 83, 83, 87, 87, 87, 87, 83, 83, 83, 83, 83, 83, 83, 83, 83, 83, 83, 83, 83, 83, 83, 83, 83, 83, 83, 83, 83, 87, 87, 87, 87, 87, 87, 87, 87, 87, 87, 87, 83, 83, 83, 83, 83, 87, 87, 87, 83, 83, 83, 83, 87, 87, 87, 83, 83, 83, 83, 83, 83, 83, 83, 83, 83, 83, 83, 83, 87 ],
  [ 87, 83, 83, 83, 83, 83, 83, 83, 83, 83, 83, 83, 83, 83, 83, 83, 83, 87, 87, 87, 87, 83, 83, 83, 83, 83, 83, 83, 83, 83, 83, 83, 83, 83, 83, 83, 83, 83, 83, 83, 87, 87, 87, 87, 87, 87, 87, 87, 87, 87, 87, 87, 87, 83, 83, 83, 83, 83, 87, 87, 87, 83, 83, 83, 87, 87, 87, 87, 83, 83, 83, 83, 83, 83, 83, 83, 83, 83, 83, 83, 83, 87 ],
  [ 87, 83, 83, 83, 83, 83, 83, 83, 83, 83, 83, 83, 83, 83, 83, 83, 83, 87, 87, 87, 87, 83, 83, 83, 83, 83, 83, 83, 83, 83, 83, 83, 83, 83, 83, 83, 83, 83, 83, 83, 87, 87, 87, 87, 87, 87, 87, 87, 87, 87, 87, 87, 87, 83, 83, 83, 83, 83, 83, 83, 83, 83, 83, 83, 87, 87, 87, 87, 83, 83, 83, 83, 83, 83, 83, 83, 83, 83, 83, 83, 83, 87 ],
  [ 87, 83, 83, 83, 83, 83, 83, 83, 83, 83, 83, 83, 83, 83, 83, 83, 83, 83, 83, 83, 83, 83, 83, 83, 83, 83, 83, 83, 83, 83, 83, 83, 83, 83, 83, 83, 83, 83, 87, 87, 87, 87, 87, 87, 87, 87, 87, 87, 87, 87, 87, 87, 87, 87, 87, 87, 83, 83, 83, 83, 83, 83, 83, 83, 87, 87, 87, 87, 83, 83, 83, 83, 83, 83, 83, 83, 83, 83, 83, 83, 83, 87 ],
  [ 87, 83, 83, 83, 83, 83, 83, 83, 83, 83, 83, 83, 83, 83, 83, 83, 83, 83, 83, 83, 83, 83, 83, 83, 83, 83, 83, 83, 83, 83, 83, 83, 83, 83, 83, 83, 83, 83, 87, 87, 87, 87, 87, 87, 87, 87, 87, 87, 87, 87, 87, 87, 87, 87, 87, 87, 83, 83, 83, 83, 83, 83, 83, 83, 87, 87, 87, 87, 83, 83, 83, 83, 83, 83, 83, 83, 83, 83, 83, 83, 83, 87 ],
  [ 87, 83, 83, 83, 83, 83, 83, 83, 83, 83, 83, 83, 83, 83, 83, 83, 83, 83, 83, 83, 83, 83, 83, 83, 83, 83, 83, 83, 83, 83, 83, 83, 83, 83, 83, 83, 83, 83, 87, 87, 87, 87, 87, 87, 87, 87, 87, 87, 87, 87, 87, 87, 87, 87, 87, 87, 83, 83, 83, 83, 87, 83, 83, 83, 87, 87, 87, 87, 83, 83, 83, 83, 83, 83, 83, 83, 83, 83, 83, 83, 83, 87 ],
  [ 87, 87, 87, 87, 87, 87, 87, 87, 87, 87, 87, 87, 87, 87, 87, 87, 87, 87, 87, 87, 87, 87, 87, 87, 87, 87, 87, 87, 87, 87, 87, 87, 87, 87, 87, 87, 87, 87, 87, 87, 87, 87, 87, 87, 87, 87, 87, 87, 87, 87, 87, 87, 87, 87, 87, 87, 87, 87, 87, 87, 87, 87, 87, 87, 87, 87, 87, 87, 87, 87, 87, 87, 87, 87, 87, 87, 87, 87, 87, 87, 87, 87 ]
]
